_______________
_PP___PPP___PP_
_PP___P|P___PP_
______P|P______
______P|P______
______P|P______
_PPPPPP|PPPPPP_
_P||||___||||P_
_PPPPPP|PPPPPP_
______P|P______
______P|P______
______P|P______
_PP___P|P___PP_
_PP___PPP___PP_
_______________



