________________________
________________________
________________________
________________________
__________s_s__PPP__s_s_
_______________P|S______
__________s_s__P|P__s_s_
_______________P|P______
_______________P|P______
__________PSPPPP|PPPPPP_
__________P|||||_|||||P_
__________PPPPPP|PPPPSP_
_______________P|P______
_______________P|P______
__________s_s__P|P__s_s_
_______________S|P______
__________s_s__PPP__s_s_
________________________



