_______________
_P_P__PPP__P_P_
______P|S______
_P_P__P|P__P_P_
______P|P______
______P|P______
_PSPPPP_PPPPPP_
_P||||___||||P_
_PPPPPP_PPPPSP_
______P|P______
______P|P______
_P_P__P|P__P_P_
______S|P______
_P_P__PPP__P_P_
_______________



