_______________
_s_s__PPP__s_s_
______P|S______
_s_s__P|P__s_s_
______P|P______
______P|P______
_PSPPPP_PPPPPP_
_P||||___||||P_
_PPPPPP_PPPPSP_
______P|P______
______P|P______
_s_s__P|P__s_s_
______S|P______
_s_s__PPP__s_s_
_______________



