_______________
_PP___PPP___PP_
_PP___P|S___PP_
______P|P______
______P|P______
______P|P______
_PSPPPP_PPPPPP_
_P||||___||||P_
_PPPPPP_PPPPSP_
______P|P______
______P|P______
______P|P______
_PP___S|P___PP_
_PP___PPP___PP_
_______________



